0;0;0;0;0
0;0;S;0;0
0;0;0;0;0
0;0;0;0;0
0;0;0;0;E